##############################
#..*******..*....*..******...#
#.....*.....*....*..*........#
#.....*.....******..****.....#
#.....*.....*....*..*........#
#.....*.....*....*..*........#
#.....*.....*....*..******...#
#............***..****.***...#
#...*...*...*...*...*..**....#
#..*.**..*..*****.*....**....#
#.*......*..*...*.****.****..#
#*...........................#
#............................#
#............................#
#............................#
#............................#
#............................#
#............................#
##############################


