##############################
#......#.........#..........?#
#.#####..####.#..#.###########
#.#.....##....####.#.........#
#....#######........#...###.##
###.##...#.#..#########.#....#
#.#....#.#.###.....#....#.#..#
#.####.#.#.#...#####..###.#..#
#...#..#.#.###..........#.#..#
#.###....#...#####.######.#.##
#...#.###.................##.#
###...##..######.######.####.#
#.....###...#..#.#.......#...#
#.###....#.....#.######..#.#.#
#.#.#...######.#.#..#.#..#.#.#
#.#.#...#....#...#....#..#.#.#
#.#.#####..###.#####.#.#.#.###
#............................#
##############################


