##############################
#...#..#..#...#.#..#...####.?#
#.#.#..#..#.#.#..#.#.#......##
#.#.#########.####.#.######.##
#.#.........#.#......#....#.##
#.#.###.#######.#####..#..#..#
#.#..#.#........#.#..####....#
#.####.#.###########.#...###.#
#.#....#.##..#...#.#.#.#####.#
#.#.#........###.#.#....#....#
#.#.####..####.#.#.####.#.####
#.#....#.....#.#.....#..#....#
#.######.#####.###.#.#.#######
#.....#...#.#....#...........#
##.#####....#...###########.##
#...#....##.#........#.#.#...#
#.#.###...###..#####...#.#.###
#.#..............#...........#
##############################


