##############################
#...#..#..#...#.#..#...#####?#
#.#.#..#..#.#.#..#.#.#..#.#..#
#.#.#######.#.####.#.#...##.##
#.#.........#.#......###..#.##
#.#.###.#############..#..#..#
#.#....#........#.#...###....#
#.####.#.###########.#...###.#
#.#..#.#.##..#.......#.#####.#
#.#.#........###.#.#....#....#
#.#.#####.####...#.####.#.####
#.#....#.....#.#.....#..#....#
#.######.#####.###.###.###.#.#
#.....#...#.#....#...#.....#.#
##.#####....#...###########.##
#...#....##.#........#.#.#...#
#.#.###.#.###..#####...#.#.###
#.#...#..........#...........#
##############################


